//MAP CONVERTED BY dmm2tgm.py THIS HEADER COMMENT PREVENTS RECONVERSION, DO NOT REMOVE
"a" = (
/turf/simulated/floor/plating/asteroid/basalt/lava_land_surface,
/area/space)
"b" = (
/obj/structure/lavaland/ash_walker,
/turf/simulated/floor/lava/lava_land_surface,
/area/space)
"d" = (
/turf/simulated/floor/lava/lava_land_surface,
/area/space)
"i" = (
/obj/structure/stone_tile/surrounding_tile{
	dir = 4
	},
/obj/structure/stone_tile/center,
/obj/structure/stone_tile/surrounding_tile/cracked{
	dir = 8
	},
/obj/structure/stone_tile/surrounding_tile/cracked{
	dir = 1
	},
/turf/simulated/floor/lava/lava_land_surface,
/area/space)
"m" = (
/obj/structure/stone_tile/block{
	dir = 8
	},
/turf/simulated/floor/lava/lava_land_surface,
/area/space)
"p" = (
/turf/simulated/wall/indestructible/boss,
/area/space)
"v" = (
/turf/space,
/area/space)
"x" = (
/obj/structure/stone_tile/surrounding_tile{
	dir = 8
	},
/obj/structure/stone_tile/center,
/obj/structure/stone_tile/surrounding_tile/cracked{
	dir = 4
	},
/obj/structure/stone_tile/surrounding_tile/cracked,
/turf/simulated/floor/lava/lava_land_surface,
/area/space)
"A" = (
/obj/structure/stone_tile/block/cracked{
	dir = 4
	},
/turf/simulated/floor/lava/lava_land_surface,
/area/space)
"J" = (
/obj/structure/stone_tile/surrounding_tile{
	dir = 1
	},
/obj/structure/stone_tile/center,
/obj/structure/stone_tile/surrounding_tile/cracked{
	dir = 4
	},
/obj/structure/stone_tile/surrounding_tile/cracked,
/turf/simulated/floor/lava/lava_land_surface,
/area/space)
"M" = (
/obj/structure/necropolis_gate,
/turf/simulated/floor/plating/asteroid/basalt/lava_land_surface,
/area/space)
"R" = (
/obj/structure/stone_tile/block/cracked,
/turf/simulated/floor/lava/lava_land_surface,
/area/space)
"V" = (
/obj/structure/stone_tile/block{
	dir = 1
	},
/turf/simulated/floor/lava/lava_land_surface,
/area/space)
"Y" = (
/obj/structure/stone_tile/surrounding_tile,
/obj/structure/stone_tile/center,
/obj/structure/stone_tile/surrounding_tile/cracked{
	dir = 8
	},
/obj/structure/stone_tile/surrounding_tile/cracked{
	dir = 1
	},
/turf/simulated/floor/lava/lava_land_surface,
/area/space)

(1,1,1) = {"
v
v
v
v
v
v
v
v
v
v
v
v
v
v
v
v
v
v
v
v
v
v
v
v
v
v
v
v
v
v
"}
(2,1,1) = {"
v
a
a
a
a
a
a
a
a
a
a
a
a
a
a
a
a
a
a
a
a
a
a
a
a
a
a
a
a
v
"}
(3,1,1) = {"
v
a
a
a
a
a
a
a
a
a
a
a
a
a
a
a
a
a
a
a
a
a
a
a
a
a
a
a
a
v
"}
(4,1,1) = {"
v
a
p
p
p
p
p
p
p
p
p
p
p
p
p
p
p
p
p
p
p
p
p
p
a
a
a
a
a
v
"}
(5,1,1) = {"
v
p
p
p
p
p
p
p
p
p
p
p
p
p
p
p
p
p
p
p
p
p
p
p
p
a
a
a
a
v
"}
(6,1,1) = {"
v
p
p
p
a
a
a
a
a
a
a
a
a
a
a
a
a
a
a
a
a
a
p
p
p
a
a
a
a
v
"}
(7,1,1) = {"
v
p
p
a
a
a
a
a
a
a
a
a
a
a
a
a
a
a
a
a
a
a
a
p
p
a
a
a
a
v
"}
(8,1,1) = {"
v
p
p
a
a
a
a
a
a
a
a
a
a
a
a
a
a
a
a
a
a
a
a
a
p
a
a
a
a
v
"}
(9,1,1) = {"
v
p
p
a
a
a
a
a
a
a
a
a
a
a
a
a
a
a
a
a
a
a
a
a
p
a
a
a
a
v
"}
(10,1,1) = {"
v
p
p
p
a
a
a
a
a
a
a
a
a
a
a
a
a
a
a
a
a
a
a
a
p
a
a
a
a
v
"}
(11,1,1) = {"
v
p
p
p
p
a
a
a
a
a
a
a
a
a
a
a
a
a
a
a
a
a
a
a
p
p
a
a
a
v
"}
(12,1,1) = {"
v
p
a
a
p
p
a
a
a
a
a
a
a
a
a
a
a
a
a
a
a
a
a
a
a
p
a
a
a
v
"}
(13,1,1) = {"
v
p
a
a
a
p
a
a
a
a
a
a
a
a
a
a
a
a
a
a
a
a
a
a
a
p
d
d
a
v
"}
(14,1,1) = {"
v
p
a
a
a
p
p
a
a
a
a
a
a
a
a
a
a
a
a
a
a
a
a
a
a
p
d
d
a
v
"}
(15,1,1) = {"
v
p
a
a
a
p
p
a
a
a
a
a
a
a
a
a
a
a
a
a
a
a
a
a
a
p
d
d
a
v
"}
(16,1,1) = {"
v
p
a
a
a
a
p
p
a
a
a
a
a
a
a
a
a
a
a
a
a
a
a
a
a
p
d
d
a
v
"}
(17,1,1) = {"
v
p
Y
A
J
a
a
p
a
a
a
a
a
a
a
a
a
a
a
a
a
a
a
a
a
p
d
d
d
v
"}
(18,1,1) = {"
v
p
R
b
V
a
a
M
a
a
a
a
a
a
a
a
a
a
a
a
a
a
a
a
a
M
d
d
d
v
"}
(19,1,1) = {"
v
p
x
m
i
a
a
p
a
a
a
a
a
a
a
a
a
a
a
a
a
a
a
a
a
p
d
d
d
v
"}
(20,1,1) = {"
v
p
a
a
a
a
p
p
a
a
a
a
a
a
a
a
a
a
a
a
a
a
a
a
a
p
d
d
a
v
"}
(21,1,1) = {"
v
p
a
a
a
p
p
a
a
a
a
a
a
a
a
a
a
a
a
a
a
a
a
a
a
p
d
d
a
v
"}
(22,1,1) = {"
v
p
a
a
a
p
p
a
a
a
a
a
a
a
a
a
a
a
a
a
a
a
a
a
a
p
d
d
a
v
"}
(23,1,1) = {"
v
p
a
a
a
p
a
a
a
a
a
a
a
a
a
a
a
a
a
a
a
a
a
a
a
p
d
d
a
v
"}
(24,1,1) = {"
v
p
a
a
p
p
a
a
a
a
a
a
a
a
a
a
a
a
a
a
a
a
a
a
a
p
a
a
a
v
"}
(25,1,1) = {"
v
p
p
p
p
a
a
a
a
a
a
a
a
a
a
a
a
a
a
a
a
a
a
a
p
p
a
a
a
v
"}
(26,1,1) = {"
v
p
p
p
a
a
a
a
a
a
a
a
a
a
a
a
a
a
a
a
a
a
a
a
p
a
a
a
a
v
"}
(27,1,1) = {"
v
p
p
a
a
a
a
a
a
a
a
a
a
a
a
a
a
a
a
a
a
a
a
a
p
a
a
a
a
v
"}
(28,1,1) = {"
v
p
p
a
a
a
a
a
a
a
a
a
a
a
a
a
a
a
a
a
a
a
a
a
p
a
a
a
a
v
"}
(29,1,1) = {"
v
p
p
a
a
a
a
a
a
a
a
a
a
a
a
a
a
a
a
a
a
a
a
a
p
a
a
a
a
v
"}
(30,1,1) = {"
v
p
p
p
a
a
a
a
a
a
a
a
a
a
a
a
a
a
a
a
a
a
a
p
p
a
a
a
a
v
"}
(31,1,1) = {"
v
p
p
p
p
p
p
p
p
p
p
p
p
p
p
p
p
p
p
p
p
p
p
p
p
a
a
a
a
v
"}
(32,1,1) = {"
v
a
p
p
p
p
p
p
p
p
p
p
p
p
p
p
p
p
p
p
p
p
p
p
a
a
a
a
a
v
"}
(33,1,1) = {"
v
a
a
a
a
a
a
a
a
a
a
a
a
a
a
a
a
a
a
a
a
a
a
a
a
a
a
a
a
v
"}
(34,1,1) = {"
v
a
a
a
a
a
a
a
a
a
a
a
a
a
a
a
a
a
a
a
a
a
a
a
a
a
a
a
a
v
"}
(35,1,1) = {"
v
v
v
v
v
v
v
v
v
v
v
v
v
v
v
v
v
v
v
v
v
v
v
v
v
v
v
v
v
v
"}
